R 1680 1080
NO  ./texture/bluestone.xpm
SO ./texture/redbrick.xpm
WE ./texture/colorstone.xpm
EA ./texture/purplestone.xpm
S ./texture/barrel.xpm
F 255, 163, 137
C 0, 255, 55

        1111111111111111111111111111111111111111111111111
        1000000000000000000000000000000000000000000000001
        1000000000000000000000000000000000000000000000001
        1000000000000002222222222000000000000000000000001
        1000000000000000000000000000000000000000000000001
        1000000000000002222222222000000000000000000000001
        1000000000000000000000000000000000000000000000001
        1101000000000000000000000000000000000000000000001
        1001000000000000000000000000000000000000000000001
111111111001000001110000000000000000000000000000000000001
100000000000000001110111101111111111111111111111111111111
11110111111111011100000010001
11110111111111011101010010001
11000000110101011100000010001
10002000000000001100000010001
10000000000000001101010000001
1100000111010101111101110001111111111111111111
11110111 1110101 10111110000000000000000000001
11111111 1111111 11111111000000000000000000001
                        1000000000000000000001
                        1000000000000000000001
                        1000000000000000000001
                        1000000000000000000001
                        10000000000000000000N1
                        1111111111111111111111