R  1500  1080
NO ./texture/bluestone.xpm
SO ./texture/redbrick.xpm
WE ./texture/colorstone.xpm
EA ./texture/purplestone.xpm
S ./texture/barrel.xpm
F 255, 163, 137
C 0, 255, 255

        1111111111111111111111111111111111111111111111111
        1000000000000000000000000000000000000000000000001
        1000000000000000000000000000000000000000000000001
        1001000000000000000000000000000000000000000000001
        1000000000000000002200000000000000000000000000001
        1000000000000000002200000000000000000000000000001
        1000000000000000000000000000000000000000000000001
        1011000000000000002000000000000000000000000000001
        1001000000000000000000000000000000000000000000001
111111111011000001110000000000000000000000000000000000001
100000000011000001110111101111111111111111111111111111111
11110111111111011100000010001
11110111111111011101010010001
11000000110101011100000010001
10002000000000001100000010001
10000000000000001101010000001
11000001110101011111011100N11111111111111111111111
11110111 1110101 1011111000000000000000000000000001
11111111 1111111 1111111111110000000000000000000001
                            10000000000000000000001
                            10000000000000000000001
                            10000000000100000000001
                            10000000000000000000001
                            10000000000000000000001
                            10011111111111111111111
                            10011111111111111
11111111111111111111111111111011
10000000000000000000000000000011
111111100011111111111111111111111
111111110001111111
120220220000022021
12022022022022021
12022022022022021
12022022022022021
12022022022022021
12022022022022021
12022022022022021
12022022022022021
12022022022022021
12022022022022021
12022022022022021
12022022022022021
12022022022022021
12022022022022021
12022022022022021
12022022022022021
12022022022022021
12022022022022021
12022022022022021
12022022022022021
12022022022022021
12022022022022021
12022022022022021
12022022022022021
12022022022022021
12022022022022021
12022022022022021
12022022022022021
12022022022022021
12022022022022021
12022022022022021
12022022022022021
12022022022022021
12022022022022021
12022022022022021
12022022022022021
12022022022022021
12022022022022021
12022022022022021
12022022022022021
12022022022022021
12022022022022021
12022022022022021
12022022022022021
12022022022022021
12022022022022021
12022022022022021
12022022022022021
12022022022022021
12022022022022021
12022022022022021
12022022022022021
12022022022022021
12022022022022021
12022022022022021
12022022022022021
12022022022022021
12022022022022021
12022022022022021
12022022022022021
12022022022022021
12022022022022021
12022022022022021
12022022022022021
12022022022022021
12022022022022021
12022022022022021
12022022022022021
12022022022022021
12022022022022021
12022022022022021
12022022022022021
12022022022022021
12022022022022021
12022022022022021
12022022022022021
12022022022022021
12022022022022021
12022022022022021
12022022022022021
12022022022022021
12022022022022021
12022022022022021
12022022022022021
12022022022022021
12022022022022021
12022022022022021
12022022022022021
12022022022022021
12022022022022021
12022022022022021
12022022022022021
12022022022022021
12022022022022021
12022022022022021
12022022022022021
12022022022022021
12022022022022021
12022022022022021
12022022022022021
12022022022022021
12022022022022021
12022022022022021
12022022022022021
12022022022022021
12022022022022021
12022022022022021
12022022022022021
12022022022022021
12022022022022021
12022022022022021
12022022022022021
12022022022022021
12022022022022021
12022022022022021
12022022022022021
12022022022022021
12022022022022021
12022022022022021
12022022022022021
12022022022022021
12022022022022021
12022022022022021
12022022022022021
12022022022022021
12022022022022021
12022022022022021
12022022022022021
12022022022022021
12022022022022021
12022022022022021
12022022022022021
12022022022022021
12022022022022021
12022022022022021
12022022022022021
12022022022022021
12022022022022021
12022022022022021
12022022022022021
12022022022022021
12022022022022021
12022022022022021
12022022022022021
12022022022022021
12022022022022021
12022022022022021
12022022022022021
12022022022022021
12022022022022021
12022022022022021
12022022022022021
12022022022022021
12022022022022021
12022022022022021
12022022022022021
12022022022022021
12022022022022021
12022022022022021
12022022022022021
12022022022022021
12022022022022021
12022022022022021
12022022022022021
12022022022022021
12022022022022021
12022022022022021
12022022022022021
12022022022022021
12022022022022021
12022022022022021
12022022022022021
12022022022022021
12022022022022021
12022022022022021
12022022022022021
12022022022022021
12022022022022021
12022022022022021
12022022022022021
12022022022022021
12022022022022021
12022022022022021
12022022022022021
12022022022022021
12022022022022021
12022022022022021
12022022022022021
12022022022022021
12022022022022021
12022022022022021
12022022022022021
12022022022022021
12022022022022021
12022022022022021
12022022022022021
12022022022022021
12022022022022021
12022022022022021
12022022022022021
12022022022022021
12022022022022021
10000000000000001
10200200200200201
10000000000000001
10000000000000001
10010000000001001
10000000000000001
10111000000011101
10000000000000001
10011000000011001
10000000000000001
10000000000000001
10000000000000001
10000000000000001
10000000000000001